MWU_BP_DEGs_amb-low.csv	amb-low
MWU_BP_DEGs_amb-low_STANDARD.csv	amb-low
MWU_BP_DEGs_amb-mod.csv	amb-mod
MWU_BP_DEGs_amb-mod_STANDARD.csv	amb-mod
MWU_BP_DEGs_mod-low.csv	mod-low
MWU_BP_DEGs_mod-low_STANDARD.csv	mod-low
MWU_BP_WGCNA-module_blue2.csv	blue2
MWU_BP_WGCNA-module_coral1.csv	coral1
MWU_BP_WGCNA-module_coral2.csv	coral2
MWU_BP_WGCNA-module_darkviolet.csv	darkviolet
MWU_BP_WGCNA-module_firebrick4.csv	firebrick4
MWU_BP_WGCNA-module_green.csv	green
MWU_BP_WGCNA-module_ivory.csv	ivory
MWU_BP_WGCNA-module_lightcyan.csv	lightcyan
MWU_BP_WGCNA-module_lightgreen.csv	lightgreen
MWU_BP_WGCNA-module_lightsteelblue.csv	lightsteelblue
MWU_BP_WGCNA-module_lightsteelblue1.csv	lightsteelblue1
MWU_BP_WGCNA-module_magenta.csv	magenta
MWU_BP_WGCNA-module_mediumpurple2.csv	mediumpurple2
MWU_BP_WGCNA-module_pink.csv	pink
MWU_BP_WGCNA-module_plum1.csv	plum1
MWU_BP_WGCNA-module_purple.csv	purple
MWU_BP_WGCNA-module_royalblue.csv	royalblue
